R	1280 720
NO	./textures/minecraft/spruce.png
SO	./textures/minecraft/spruce.png
WE	./textures/minecraft/oak.png
EA	./textures/minecraft/oak.png

FL	./textures/minecraft/grass.png
CL	./textures/minecraft/leaves.png
S	./textures/minecraft/poppy.xpm
S3	./textures/minecraft/porkchop.xpm
S4	./textures/minecraft/diamond.xpm
F	80,80,80
C	120,120,255

    11111111111111111111111111111
    1 1 1000000002110000000000001
    11111011000001110000200000001
        1001000000000030000000001
111111111011000001110000000010001
1000000000110000011101111111 1111
11110111111111011100000010001
11110111111111011101010010001
 1000000112121011100000010001
10000000000000000000000010201
1E033302000040001101010010001
10000000000000001101010010001
1100000011012121111121111000111
11112111 1112121 101111010001
11111111 1111111 11111111111
