R 1280 720
NO	./textures/paintings/match.xpm
SO	./textures/paintings/pigscene.xpm
WE	./textures/paintings/pointer.xpm
EA	./textures/paintings/wasteland.xpm

S	./textures/cone.xpm
F	80,80,80
C	120,120,255

111111111111111111111111
110002222211111111000001
11E202100000000000000001
110002220211111111000001
100000000011111111111111
11111111111
