R 1280 720
NO	./textures/wolf/mossy.xpm
SO	./textures/wolf/greystone.xpm
WE	./textures/wolf/wood.xpm
EA	./textures/wolf/colorstone.xpm

S	./textures/cone.xpm
F	80,80,80
C	120,120,255

111111111111111111111111
110002222211111111000001
11S202100000020000000001
110002220211101111000001
100000000011111111111111
11111111111
