R	1280	720
NO	./path_to_the_north_texture
SO	./path_to_the_south_texture
WE	./path_to_the_west_texture
EA	./path_to_the_east_texture

S	./textures/test.xpm
F	220,100,0
C	225,30,0

111111111111111111111111111111111111111111111
100000000000000000000000000000000000000000001
100000000000000000000000000000000000000000001
100000000000000000000000000000000000000000001
100000000000000000000000000000000000000000001
100000000000000000000000000000000000000000001
1000000011111111111100N0000000000000000000001
100000001000000000010000000000000000000000001
100000001000000000010000000000000000000000001
100000001000000000010000000000000000000000001
100000001000000000010000000000000000000000001
100000001000000000010000000000000000000000001
100000001000000000010000000000000000000000001
100000001000000000010000000000000000000000001
100000001000000000010000000000000000000000001
100000001000000000010000000000000000000000001
100000001000000000010000000000000000000000001
100000001111111011110000000000000000000000001
100000000000000000000000000000000000000000001
100000000000000000000000000000000000000000001
100000000000000000000000000000000000000000001
11111111111111111111111111111111111111111111
