R	1280	720
NO	./textures/mossy.xpm
SO	./textures/greystone.xpm
WE	./textures/wood.xpm
EA	./textures/colorstone.xpm

S	./textures/cone.xpm
F	80,80,80
C	120,120,120

111111111111111111111111111111111111111111111
100000000000000000000000000000000000000000001
100000000000000000000000000000000000000000001
100000000000000000000000000000000000000000001
100000000000000000000000000000000000000000001
100000000000000000000000000000000000000000001
1000000011111111111100W0000000000000000000001
100000001000000000010000000000000000000000001
100000001000000000010000000000000000000000001
100000001000000000010000000000000000000000001
100000001000000000010000000000000000000000001
100000001000000000010000000000100000000000001
100000001000000000010000000000000000000000001
100000001000000000010000000000000000000000001
100000001000000000010000000000000000000000001
100000001000000000010000000000000000000000001
100000001000000000010000000000000000000000001
100000001111000001110000000000000000000000001
100000000000000000000000000000000000000000001
100000000000000000000000000000000000000000001
100000000000000000000000000000000000000000001
100000000000000000000000000000000000000000001
100000000000000000000000000000000000000000001
111111111111111111111111111111111111111111111
